1111111111111111111111111111111111111111111111111111111111111111111111111111111111111111111111111
1111111111111111111111111111111111111111111111111111111111111111111111111111111111111111111111111
1111111111111111111111111111111111111111111111111111111111111111111111111111111111111111111111111
1111111111111111111111111111111111111111111111111111111111111111111111111111111111111111111111111
1000000000000000000000000000000000000000000000000000000000000000000000000000000000000000000011111
1000000000000000000000000000000000000000000000000000000000000000000000000000000000000000000011111
1555555555555555555555555555555555555555555555555555555555555555555555555555555555555555500011111
1000000000000000000000000000000000000000000000000000000000000000000000000000000000000011100011111
1000000000000000000000000000000000000000000000000000000000000000000000000000000000000411100011111
1000555555555333555555555255555255555255555255552555525555355535553555355355355355355511100011111
1000000000000000000000000000000000000000000000000000000000000000000000000000000000000311100011111
1100000000000000000000000000000000000000000000000000000000000000000000000000000000000011100011111
1115555555555555552255555555533335555555555555555555555533355555533355555555555555500011100011111
1000000000000000001100000000003300000000000000000000000003000000003000000000000000000011100011111
1000000000000000000000000000000000000000000000000000000000000000000000000000000000000111100011111
1000000011000000000000222000000000220000000220000000220000003330000000000000222200001111100011111
1000555555555555555555555555555555555555555555555555555555555555555555555555555555511111100011111
1000000033300000000000330000000000000001111111111000000000000000000022200000000000011111100011111
1100000000000000000000000000000000000000000000000000000000000000000000000000000000000000000011111
1110000000000002000000000000222000000000000000000000333000000333000000000000011110000000000011111
1111555555555555555555555555555555555555555555555555555555555555555555555555555555555555555511111