1111111111111111111111111111111111111111111111111111111111111111111111111111111111111111111111111
1111111111111111111111111111111111111111111111111111111111111111111111111111111111111111111111111
1111111111111111111111111111111111111111111111111111111111111111111111111111111111111111111111111
0000000000000000111111111111111111111111111111111111111111111111111111111111111111111111111111111
0000000000000000000000000000000000000000000000000000000001111111111111111111111111111111111111111
1111111111111100000000000000000000000000000000000000000001111111111111111111111111111111111111111
1111111111111111555555555555222133312222111000000000000001111111111111111111111111111111111111111
1111111111111111111111111111222133312222111113333333311001111111111111111111111111111111111111111
1111111111111111111111111111111111111111111113333333311001111111111111111111111111111111111111111
1111111111111111111111111111111111111111111111111111111001111111111111111111111111111111111111111
1111111111111111111111111111111111111111111111111111111001111111111111111111111111111111111111111
1111111111111111111111111111111111111111111111111111111001111111111111111111111111111111111111111
1100000000000000000000000000000000000000000000000000000001111111111111111111111111111111111111111
1100000000000000000000000000000000000000000000000000000000000000000000000000000000000000011111111
1122222222225555555555555555555555555555555555555555555500000000000000000000000000000000011111111
1122222222221111111111111111111111111111111111111111111133555555555555555555555555555533411111111
1111111111111111111111111111111111111111111111111111111133111111111111111111111111111133111111111
1111111111111111111111111111111111111111111111111111111133111111111111111111111111111133111111111
1111111111111111111111111111111111111111111111111111111111111111111111111111111111111111111111111
1111111111111111111111111111111111111111111111111111111111111111111111111111111111111111111111111
1111111111111111111111111111111111111111111111111111111111111111111111111111111111111111111111111