0000000000000000000000000000000000000000000000
0000000000000000000000000000000000000000000000
0000000000000000000000000000000000000000000000
0000000000000000000000000000000000000000000000
0000000000000000000000000000000000000000000000
0000000000000000000000000000000000000000000000
1111000000055222222222222225555533551111111411
0000000000001222222222222221000133100000001110
0000000000001222222222222221000133100000000000
0000000000001222222222222221000133100000000000
0000000000001111111111111111000111100000000000