10001111111111111111111111111111111111111111111
10001000000000000000000000000000000000000000001
10001000000000000000000000000000000000000000041
10001000005522533353352255522252255222253331111
10001100000000000000000000000000000000000000001
10001110000000000000000000000000000000000000001
10001111555555555555555555555555555555555555001
10001000000000000200000200000000000002000002001
10000000000000000000000000000000000000000000001
10000000000000000000000000000000000000000000001
11111555555555555555222221222225552225522222111